"Date","CHINOOK","JACK","ALLCHINOOK","SCHUM","FCHUM","COHO","PINK","SOCKEYE","CISCO","BROAD","HUMPBACK","SHEEFISH","OTHER","ALLOTHER"
"06/07/2023",0,0,0,0,0,0,0,0,9636,5110,554488,1409531,346819,2325584
"06/08/2023",0,0,0,0,0,0,0,0,8196,3447,610389,1243339,389943,2255314
"06/09/2023",0,0,0,0,0,0,0,0,6646,3129,638806,972104,416869,2037554
"06/10/2023",249127,0,249127,0,0,0,0,0,3011,1072424,0,891981,0,1967416
"06/11/2023",61155,0,61155,0,0,0,0,0,1133,256669,0,358321,0,616123
"06/12/2023",8196,24882,33078,93276,0,0,0,0,172802,54007,26808,46557,0,300174
"06/13/2023",41780,119062,160842,434348,0,0,0,0,808419,242828,130273,208850,0,1390370
"06/14/2023",0,0,0,853078,0,0,0,0,4312002,4329,0,8851076,0,13167407
"06/15/2023",9396373,2999,9399372,1623835,0,0,0,0,1251688,0,0,121347,187541,1560576
"06/16/2023",312712,33618,346330,533978,0,0,0,0,9250700,1676026,0,3980908,64714,14972348
"06/17/2023",1262172,108180,1370352,1459972,0,0,0,0,3712592,0,0,25008,240998,3978598
"06/18/2023",183903,117260,301163,8123745,0,0,0,0,133626,325766,0,46892,0,506284
"06/19/2023",563759,26264,590023,9568598,0,0,0,0,1892519,74730,0,256540,0,2223789
"06/20/2023",58305,49800,108105,4933060,0,0,0,0,169056,0,0,0,19935,188991
"06/21/2023",2008735,83482,2092217,10317297,0,0,0,0,1748189,0,149390,5156,91449,1994184
"06/22/2023",184994,0,184994,7142115,0,0,0,0,81430,64308,0,0,0,145738
"06/23/2023",10676114,2847,10678961,19053488,0,0,0,0,9121700,0,73902,52383,0,9247985
"06/24/2023",402069,171259,573328,13294250,0,0,0,0,3587009,20193,39425,56590,0,3703217
"06/25/2023",91081,73404,164485,5758605,0,0,0,0,2464355,7800,116077,8327,0,2596559
"06/26/2023",13409,10876,24285,1348541,0,0,0,0,69109,0,0,0,257877,326986
"06/27/2023",38955,394,39349,387874,0,0,0,0,29374,0,0,0,92771,122145
"06/28/2023",225440,8572,234012,4455934,0,0,0,0,78379,0,0,13410,175454,267243
"06/29/2023",235914,134382,370296,12078593,0,0,0,79586,1183634,20909,66469,11618,0,1282630
"06/30/2023",2115731,1023250,3138981,2277094,0,0,0,0,696659,6536,483539,611069,18913,1816716
"07/01/2023",244340,12611,256951,705714,0,0,0,0,514637,24332,221618,633695,8952,1403234
"07/02/2023",56836,175375,232211,293109,0,0,0,0,272546,12142,2481,2230,6385,295784
"07/03/2023",107585,326318,433903,631825,0,0,0,0,464817,21045,33086,16920,40485,576353
"07/04/2023",404792,270734,675526,5548083,0,0,0,0,688501,40058,0,564250,161833,1454642
"07/05/2023",1304549,169017,1473566,53627263,0,0,0,615315,2238040,0,557716,115307,5401,2916464
"07/06/2023",1545939,144081,1690020,32801953,0,0,0,386249,1359327,0,343523,69055,2835,1774740
"07/07/2023",252156,71384,323540,24028804,0,0,0,0,18449910,0,0,839766,0,19289676
"07/08/2023",40855,36331,77186,1542963,0,0,0,0,473622,0,333306,19607,7650,834185
"07/09/2023",115738,0,115738,2262946,0,0,0,20660,1994292,0,322618,68348,10548,2395806
"07/10/2023",173520,508204,681724,51463618,0,0,0,0,1639690,0,49131,256748,0,1945569
"07/11/2023",594948,1717532,2312480,40242284,0,0,0,0,88508,0,666829,34315,204144,993796
"07/12/2023",22530794,172611,22703405,25333058,0,0,0,0,2763469,0,231266,0,0,2994735
"07/13/2023",14041191,0,14041191,85421578,0,0,0,0,4422151,0,665359,0,216618,5304128
"07/14/2023",200225,108349,308574,16531087,0,0,0,51168,8288405,113144,0,141120,23625,8566294
"07/15/2023",127644,217667,345311,3656954,0,193073,0,0,3607319,1514139,608991,528264,68257,6326970
"07/16/2023",5193,0,5193,13993862,0,0,897342,53508,872506,1423222,1100789,0,236202,3632719
"07/17/2023",58223,0,58223,14144945,0,0,0,128311,7992764,0,226966,0,0,8219730
"07/18/2023",0,0,0,2096088,0,0,0,0,193231,0,634282,33337,0,860850
"07/19/2023",0,68722,68722,0,13072143,0,413769,97100,20129744,0,133584,647330,0,20910658
"07/20/2023",0,0,0,0,3173650,0,0,152088,17040034,44001,5409869,0,128573,22622477
"07/21/2023",0,0,0,0,1983670,0,869907,0,20354004,109597,13130981,72722,74435,33741739
"07/22/2023",0,0,0,0,689511,0,221461,210925,3326393,826,1877972,5486,22658,5233335
"07/23/2023",0,27376,27376,0,443559,0,514833,53841,2489569,1323819,2578170,50673,0,6442231
"07/24/2023",0,0,0,0,1612750,8443,364674,0,5190325,234449,3330303,107965,8864,8871906
"07/25/2023",0,0,0,0,466837,0,287814,0,6104674,32569,1543037,372881,0,8053161
"07/26/2023",0,0,0,0,416317,0,77106,0,6487244,28488,5997676,159571,0,12672979
"07/27/2023",0,0,0,0,216918,0,62179,0,1674347,279627,1940030,108142,0,4002146
"07/28/2023",0,0,0,0,387687,0,0,0,448573,50187,1263792,59862,0,1822414
"07/29/2023",0,0,0,0,32272853,0,91216,0,574134,70954,31055788,18766,0,31719642
"07/30/2023",0,0,0,0,512638,0,165681,0,5860269,0,3954355,1314,149072,9965010
"07/31/2023",0,0,0,0,210823,0,110381,31446,1515676,10484,2936951,58270,62583,4583964
"08/01/2023",0,0,0,0,3594610,0,98479,5049,5331804,78898,700456,15519,0,6126677
"08/02/2023",0,0,0,0,981608,30956,15119,0,2529519,38623,1155196,4124,216364,3943826
"08/03/2023",0,0,0,0,876352,0,26467,4614,3801457,340709,1595441,40273,29274,5807154
"08/04/2023",0,0,0,0,95049,0,0,10786,8862288,5727,7007446,0,0,15875461
"08/05/2023",0,0,0,0,4423,0,0,14696,1371891,11713,1349084,0,0,2732688
"08/06/2023",0,0,0,0,47466,0,0,0,842395,34857,484239,15947,1552,1378990
"08/07/2023",0,0,0,0,20415407,0,0,0,12937553,117468,2182453,2613,123360,15363447
"08/08/2023",0,0,0,0,14861746,0,292050,0,3705176,405970,7404234,0,665,11516045
"08/09/2023",0,0,0,0,19071190,69787,0,360139,15072753,774447,77494,3693,98559,16026946
"08/10/2023",0,0,0,0,16617624,159637,0,14439,27025699,17156,4810607,0,1292695,33146157
"08/11/2023",0,0,0,0,2168546,568620,11387,0,134121,177400,3382962,6249,0,3700732
"08/12/2023",0,0,0,0,397791,136089,87192,0,1666876,1207267,1556808,779,37604,4469334
"08/13/2023",0,0,0,0,475323,207302,0,20156,2110363,796375,858916,44623,19817,3830094
"08/14/2023",0,0,0,0,3174160,61802,0,0,253658,360434,1550461,26425,5185,2196163
"08/15/2023",0,0,0,0,113997,69495,0,0,3268269,12965,2385577,11532,201074,5879417
"08/16/2023",0,0,0,0,274074,164030,0,0,1485924,542905,778274,79968,0,2887071
"08/17/2023",0,0,0,0,826561,2683630,0,0,4338972,0,1403821,0,184596,5927389
"08/18/2023",0,0,0,0,1174439,349418,0,0,127643,1751396,1773560,0,91787,3744386
"08/19/2023",0,0,0,0,1194215,338067,0,0,1645998,33786,719900,12828,42498,2455010
"08/20/2023",0,0,0,0,2147920,1849825,0,0,0,69481,148527,81835,0,299843
"08/21/2023",0,0,0,0,8619217,1857065,67694,0,226090,0,0,0,0,226090
"08/22/2023",0,0,0,0,1893419,1007010,0,0,969439,40483,74215,12332,6912,1103381
"08/23/2023",0,0,0,0,2000030,962355,0,0,337838,43742,172698,0,11173,565451
"08/24/2023",0,0,0,0,1783900,1965217,0,0,0,278440,548062,0,161703,988205
"08/25/2023",0,0,0,0,1277859,707725,0,0,6294792,78733,385858,0,13984,6773367
"08/26/2023",0,0,0,0,1905320,1579543,0,0,310029,111975,885105,0,308374,1615483
"08/27/2023",0,0,0,0,1352131,860236,0,5383,1667244,24049,595484,0,0,2286777
"08/28/2023",0,0,0,0,1532500,25317,0,0,296674,63521,621974,0,12274,994443
"08/29/2023",0,0,0,0,806808,285797,0,0,451494,35896,294149,0,8919,790458
"08/30/2023",0,0,0,0,791589,1390017,0,0,211959,0,109229,0,23267,344455
"08/31/2023",0,0,0,0,639828,966943,0,0,30104,37554,213796,0,170950,452404
"09/01/2023",0,0,0,0,1346148,105466,0,0,2805265,14462,200303,0,0,3020030
"09/02/2023",0,0,0,0,1149720,233287,0,0,229192,126339,329371,0,13974,698876
"09/03/2023",0,0,0,0,2461003,2297705,0,0,1135855,206375,0,0,4095,1346325
"09/04/2023",0,0,0,0,125957,336062,0,0,315947,3167,55796,0,3080,377990
"09/05/2023",0,0,0,0,133781,445935,0,0,80600,53354,31159,0,72864,237977
"09/06/2023",0,0,0,0,73523,294556,0,0,49271,16141,20622,0,72314,158348
"09/07/2023",0,0,0,0,375573,140281,0,0,82813,26381,7930,0,228672,345796
"Total Variance",69934452,6016843,75951295,478063815,172240163,22350691,4674751,2315459,300317550,17109483,129911242,24515691,7199988,479053954
"Std Error",8362.68211,2452.9254,8715.00401606333,21864.67048,13124.02998,4727.65174,2162.11725,1521.66323,17329.67253,4136.36108,11397.86129,4951.33224,2683.27934,21887.3012041229
