Date,CHINOOK,JACK,ALLCHINOOK,SCHUM,FCHUM,COHO,PINK,SOCKEYE,CISCO,BROAD,HUMPBACK,SHEEFISH,OTHER,ALLOTHER
6/1/2022,0,0,0,0,0,0,0,0,1227,968,0,324,174,2693
6/2/2022,0,0,0,0,0,0,0,0,2668,1957,0,457,303,5385
6/3/2022,0,0,0,0,0,0,0,0,2288,1692,0,414,267,4661
6/4/2022,0,0,0,0,0,0,0,0,2617,232,0,899,68,3816
6/5/2022,0,0,0,0,0,0,0,0,1066,215,0,433,63,1777
6/6/2022,0,92,92,0,0,0,0,0,1202,219,0,393,58,1872
6/7/2022,174,43,217,0,0,0,0,0,608,102,319,199,27,1255
6/8/2022,232,88,320,0,0,0,0,0,933,211,425,317,56,1942
6/9/2022,227,83,310,1,0,0,0,0,893,197,414,302,52,1858
6/10/2022,336,107,443,0,0,0,0,0,695,302,642,413,0,2052
6/11/2022,325,100,425,1,0,0,0,0,668,281,603,404,0,1956
6/12/2022,226,87,313,327,0,0,0,0,523,283,269,766,37,1878
6/13/2022,212,66,278,290,0,0,0,0,394,238,304,680,42,1658
6/14/2022,815,0,815,1072,0,0,0,0,0,215,171,570,0,956
6/15/2022,991,0,991,1296,0,0,0,0,0,229,215,630,0,1074
6/16/2022,610,155,765,1226,0,0,0,0,0,291,4,639,0,934
6/17/2022,657,229,886,1586,0,0,0,0,711,228,0,400,73,1412
6/18/2022,879,524,1403,1604,0,0,0,0,961,468,0,657,68,2154
6/19/2022,446,312,758,2549,0,0,0,0,612,154,0,613,50,1429
6/20/2022,598,247,845,1815,0,0,0,0,1599,0,0,388,76,2063
6/21/2022,494,310,804,1436,0,0,0,0,1088,0,503,375,90,2056
6/22/2022,594,232,826,708,0,0,0,0,723,0,377,579,151,1830
6/23/2022,966,300,1266,349,0,0,0,0,1772,0,0,756,168,2696
6/24/2022,1593,286,1879,5962,0,0,0,0,40,0,86,1017,0,1143
6/25/2022,2119,852,2971,35735,0,0,0,0,919,0,0,604,0,1523
6/26/2022,2087,2563,4650,48685,0,0,0,0,781,0,0,197,0,978
6/27/2022,635,1082,1717,29621,0,0,0,0,3874,0,1455,462,0,5791
6/28/2022,2819,1003,3822,18884,0,0,378,102,1147,0,972,1130,0,3249
6/29/2022,1634,620,2254,15473,0,0,768,192,4593,0,855,618,0,6066
6/30/2022,2589,0,2589,22620,0,0,1003,0,2944,0,0,0,565,3509
7/1/2022,1401,520,1921,26358,0,0,303,144,2156,0,819,257,0,3232
7/2/2022,711,1124,1835,18640,0,0,390,219,5142,0,169,864,344,6519
7/3/2022,629,716,1345,7634,0,0,1820,380,8907,135,616,417,0,10075
7/4/2022,1275,422,1697,6156,0,0,4773,0,6370,0,2752,348,255,9725
7/5/2022,478,207,685,19105,0,0,3749,0,8243,0,4305,76,100,12724
7/6/2022,780,799,1579,18816,0,0,1938,94,4714,0,6319,494,0,11527
7/7/2022,914,121,1035,11227,0,0,4514,292,7403,0,1069,244,199,8915
7/8/2022,413,0,413,8473,0,0,3572,0,5465,0,4038,793,0,10296
7/9/2022,622,0,622,5940,0,0,6425,0,6163,0,1896,278,54,8391
7/10/2022,740,271,1011,9445,0,0,3956,0,2559,406,1070,173,62,4270
7/11/2022,564,0,564,13030,0,0,3364,0,3943,0,953,186,87,5169
7/12/2022,258,238,496,18875,0,0,7020,140,6413,321,5190,1002,0,12926
7/13/2022,0,104,104,26494,0,0,5642,0,4589,0,3509,565,0,8663
7/14/2022,700,0,700,16111,0,0,10913,284,7333,176,3264,88,0,10861
7/15/2022,505,310,815,12451,0,0,11147,369,2003,0,11813,383,0,14199
7/16/2022,0,0,0,23610,0,0,11357,117,4094,0,5243,452,0,9789
7/17/2022,157,0,157,16832,0,0,7235,0,3419,0,9011,223,0,12653
7/18/2022,0,385,385,13369,0,0,9445,356,3724,0,4349,0,0,8073
7/19/2022,198,181,379,0,13098,0,9073,0,4615,0,7177,692,513,12997
7/20/2022,157,0,157,0,9280,0,7387,0,4409,1632,902,534,0,7477
7/21/2022,243,0,243,0,13727,0,2946,0,2060,107,2397,344,0,4908
7/22/2022,106,182,288,0,12212,0,2477,0,5387,571,277,474,0,6709
7/23/2022,0,163,163,0,7738,0,4712,0,2935,30,1983,729,0,5677
7/24/2022,50,0,50,0,4229,0,6971,0,1060,0,3478,107,107,4752
7/25/2022,0,0,0,0,7261,0,841,142,621,0,1039,436,0,2096
7/26/2022,0,0,0,0,3574,0,2002,97,998,39,913,107,0,2057
7/27/2022,0,156,156,0,3974,51,3037,0,1862,120,1863,0,0,3845
7/28/2022,0,0,0,0,1550,0,4832,29,2742,207,1495,183,82,4709
7/29/2022,0,0,0,0,2612,166,2068,47,3216,0,2588,323,126,6253
7/30/2022,0,0,0,0,5198,0,2078,0,1608,59,1872,141,0,3680
7/31/2022,0,0,0,0,4103,0,1273,144,2846,0,1472,387,0,4705
8/1/2022,0,0,0,0,2271,145,1644,0,3319,0,1894,0,265,5478
8/2/2022,0,0,0,0,3390,439,1109,186,2760,319,1133,0,0,4212
8/3/2022,0,0,0,0,4309,55,1179,0,1247,292,3190,63,487,5279
8/4/2022,0,0,0,0,1742,165,538,111,1713,0,4183,0,0,5896
8/5/2022,0,0,0,0,299,169,519,0,4335,49,2179,193,105,6861
8/6/2022,0,0,0,0,594,0,283,0,1226,636,4178,281,195,6516
8/7/2022,0,0,0,0,919,462,1059,0,2245,0,2591,156,0,4992
8/8/2022,0,0,0,0,2708,1225,467,0,1613,0,3239,0,0,4852
8/9/2022,0,0,0,0,25152,1308,635,0,2166,188,1698,0,0,4052
8/10/2022,0,0,0,0,22412,1287,1766,0,3786,326,2579,60,864,7615
8/11/2022,0,0,0,0,18721,1545,106,0,1429,527,2258,51,293,4558
8/12/2022,0,0,0,0,16374,1206,0,0,2247,45,1923,39,301,4555
8/13/2022,0,0,0,0,6435,2160,0,82,3046,695,3247,77,345,7410
8/14/2022,0,0,0,0,2556,2389,53,0,2682,35,3455,35,192,6399
8/15/2022,0,0,0,0,1891,2615,0,0,1882,248,2514,0,34,4678
8/16/2022,0,0,0,0,1525,1655,0,0,1860,303,2762,0,182,5107
8/17/2022,0,0,0,0,7794,732,0,0,4326,226,4393,0,173,9118
8/18/2022,0,0,0,0,25687,3306,0,403,2431,656,3336,0,178,6601
8/19/2022,0,0,0,0,14216,5695,0,0,4539,328,2349,0,251,7467
8/20/2022,0,0,0,0,15009,6516,0,0,1781,382,2560,0,42,4765
8/21/2022,0,0,0,0,11467,5567,0,0,3396,0,1090,0,682,5168
8/22/2022,0,0,0,0,5796,4491,0,0,2502,341,1483,58,70,4454
8/23/2022,0,0,0,0,2941,5091,0,0,407,1162,1259,0,52,2880
8/24/2022,0,0,0,0,2581,4841,0,0,819,0,244,192,57,1312
8/25/2022,0,0,0,0,2583,1769,0,0,1466,287,661,0,44,2458
8/26/2022,0,0,0,0,2493,1568,0,0,1490,259,714,0,52,2515
8/27/2022,0,0,0,0,1261,1816,0,0,1407,0,879,0,35,2321
8/28/2022,0,0,0,0,1931,2882,0,0,1174,263,1212,0,111,2760
8/29/2022,0,0,0,0,5869,3234,0,0,1474,309,865,120,0,2768
8/30/2022,0,0,0,0,5538,5806,0,71,147,481,886,194,0,1708
8/31/2022,0,0,0,0,3616,5460,0,66,1106,167,613,214,0,2100
9/1/2022,0,0,0,0,5489,4069,0,0,2269,60,205,0,210,2744
9/2/2022,0,0,0,0,4302,3304,0,75,357,262,608,80,165,1472
9/3/2022,0,0,0,0,1957,2821,0,0,647,362,396,47,65,1517
9/4/2022,0,0,0,0,1672,2398,0,0,387,0,833,0,58,1278
9/5/2022,0,0,0,0,690,1345,0,42,1849,0,0,0,353,2202
9/6/2022,0,0,0,0,1162,1122,0,0,591,526,724,0,107,1948
9/7/2022,0,0,0,0,1809,1227,0,0,1364,0,763,106,194,2427
